
巴士底	bsdi
帮扶	bsfu
帮工	bsgl
棒喝	bshe
白色家电	bsjd
棒极	bsji
榜姐	bsjx
帮腔	bsqc
白森森	bssn
帮凶	bsxl
半山腰	bsyd
梆硬	bsyg
榜眼	bsyj
榜样	bsys
棒状	bszc
棒子	bszi
碑学	bwxz
百无一用是书生	bwys
必须要	bxyd
别样	bxys
避孕药	byyd
别有一番	byyf
必有一失	byys
不知其二	bzqv
不正确	bzqz
别这样	bzys
鼻子眼儿	bzyv
超大尺度	cdcd
仇敌	cddi
抽刀断水水更流	cddl
超大附件	cdfj
吃豆腐	cdfu
才德兼备	cdjb
丑角	cdjh
唱独角戏	cdjx
柴达木	cdmu
充电器	cdqi
持刀抢劫	cdqj
仇视	cdsi
车到山前必有路	cdsl
菜单项	cdxc
酬谢	cdxx
差得远	cdyt
承担责任	cdzr
茶饭不思	cfbs
处方笺	cfjf
穿甲	cfjs
川军	cfjy
乘法口诀	cfkj
餐风露宿	cfls
触发器	cfqi
餐风宿露	cfsl
充分说明	cfsm
充分体会	cfth
船体	cfti
财付通	cftl
穿行	cfxg
尘封已久	cfyj
豺狼	chls
菜品	chpc
采用	chvl
采样	chys
餐车	cjcs
残阳	cjys
草鱼	ckyv
冲撞	clbc
初露端倪	cldn
冲浪	clls
春兰秋菊	clqj
城邦	cmbs
成样	cmys
呈阅	cmyz
查水表	csbd
侧边	csbf
测报	csbk
车程	cscm
采石场	cscp
车店	csdf
车贷	csdh
彻底	csdi
彩色电视机	csdj
参赛队	csdv
车盖	csgh
策划	cshs
参赛者	csje
车间	csjf
车技	csji
车驾	csjs
测距	csju
测距	csjv
车里	csli
侧漏	cslr
操碎了心	cslx
车门	csmn
车迷	csmt
侧切	csqx
侧身	cssn
撤退	cstv
车型	csxg
车削	csxz
财神爷	csye
才是一个	csyg
扯远	csyt
参赛者	csze
车站	cszj
彩色照片	cszp
穿帮	ctbs
传扬	ctys
惩恶扬善	cvys
蔡卓妍	czyf
杜邦线	dbxj
大打出手	ddcs
店大欺客	ddqk
掉血	ddxz
得到一种	ddyz
大幅下降	dfxj
道高一丈	dgyz
大灰狼	dhls
大呼小叫	dhxj
抵抗	diks
淡妆	djbc
打简出繁	djcf
单车	djcs
胆囊	djns
但却	djqz
大局已定	djyd
倒忙	dkms
道歉	dkqj
导线	dkxj
岛屿	dkyv
地理学家	dlxj
洞箫	dlxk
鼎力相助	dlxz
打了一顿	dlyd
的目标是	dmbs
单名一个字	dmyz
电脑包	dnbk
大男大女	dndn
跌宕	dndp
爹爹	dndx
大难临头各自飞	dnlf
电暖气	dnqi
大闹天宫	dntg
电脑桌	dnzo
当前	dpqj
低人一等	dryd
代数学	dsxz
掉头就走	dtjz
大案要案	dvyv
带薪休假	dxxj
喋血	dxxz
大西洋	dxys
大有玄机	dyxj
的原因是	dyys
的这样	dzys
繁忙	fjms
费尽心机	fjxj
繁衍	fjyf
风靡一时	fmys
粉蝶	fndn
否决	frjz
仿生学	fsxz
浮夸	fuks
飞仙	fwxj
访问学者	fwxz
飞跃	fwyz
飞转	fwzb
高度一致	gdyz
改换门庭	ghmt
赶车	gjcs
赶走	gjjr
感觉	gjjz
赶忙	gjms
敢拼	gjpc
高奏	gkjr
高亢	gkks
公车	glcs
贡献	glxj
公寓	glyv
公转	glzb
更小	gmxk
刚柔相济	grxj
隔山打牛	gsdn
故事情节	gsqj
更重要	gzyd
还不一定	hbyd
毫不掩饰	hbys
慌忙	hcms
坏疽	hgjv
海浪	hhls
还小	hhxk
海燕	hhyf
海洋	hhys
旱船	hjcf
汗腺	hjxj
涵养	hjys
好车	hkcs
耗能	hkns
还可以说	hkys
红榜	hlbs
喝了一口水	hlys
衡阳	hmys
汗牛充栋	hncd
后帮	hrbs
后浪	hrls
好事成双	hscs
横扫千军	hsqj
好生羡慕	hsxm
糊涂一时	htys
华而不实	hvbs
换而言之	hvyz
毫无准备	hwzb
很需要	hxyd
花样百出	hybc
鸿雁传书	hycs
很有价值	hyjz
还有一种	hyyz
会这样	hzys
禁绝	jbjz
锦囊	jbns
金钱	jbqj
基本情况	jbqk
基础学科	jcxk
胶棒	jdbs
机动车道	jdcd
胶州	jdjr
监督机制	jdjz
胶囊	jdns
鸡蛋碰石头	jdpt
娇小	jdxk
教学	jdxz
教养	jdys
奸夫淫妇	jfyf
简阳	jfys
精囊	jgns
金鼓齐鸣	jgqm
精耕细作	jgxz
几个意思	jgys
节骨眼儿	jgyv
计划经济体制	jhjz
击垮	jiks
急救车	jjcs
经济学家	jjxj
交浅言深	jqys
竟然不是词	jrbc
绞肉机	jrji
贱人就是矫情	jrjq
节日礼物	jrlw
加热器	jrqi
既然是	jrsi
急人所急	jrsj
假如说	jrso
金融危机	jrwj
截然相反	jrxf
兼容性	jrxg
金融业	jrye
孑然一身	jrys
救人一命胜造七级浮屠	jryt
金融资本	jrzb
进入状态	jrzt
杰士邦	jsbs
积少成多	jscd
家传	jscf
加州	jsjr
加密	jsmt
家学	jsxz
佳肴	jsyd
家养	jsys
交通运输	jtys
吉尔吉斯	jvjs
久而久之	jvjz
接二连三	jvls
骄傲自满	jvzm
家务活	jwho
接棒	jxbs
皆能	jxns
解聘	jxpc
揭破	jxpr
揭晓	jxxk
解药	jxyd
教育程度	jycd
教育出版社	jycs
疾言厉色	jyls
金玉满堂	jymt
娇艳欲滴	jyyd
酒糟鼻	jzbi
居住地	jzdi
集中到	jzdk
建筑队	jzdv
江浙沪	jzhu
奖助金	jzjb
竞争者	jzje
假正经	jzjg
谨遵教诲	jzjh
简直就是	jzjs
尽职尽责	jzjz
决裂	jzlx
价值论	jzly
拒之门外	jzmw
九洲四海	jzsh
就只是	jzsi
尖子生	jzsm
接着说	jzso
技战术	jzsu
集装箱	jzxc
建筑学	jzxh
甲状腺肿	jzxz
姜子牙	jzya
脊柱炎	jzyf
教职员	jzyt
就在于	jzyu
就在于	jzyv
竞争者	jzze
记者站	jzzj
就在这里	jzzl
卡丁车	kdcs
考古学家	kgxj
开掘	khjz
慷慨激昂	kkjv
慷慨相助	kkxz
空余	klyv
抗暴	ksbk
扛鼎	ksdg
抗毒	ksdu
康复	ksfu
抗非	ksfw
亢进	ksjb
扛着	ksje
抗击	ksji
康乐	ksle
抗老	kslk
扛枪	ksqc
康桥	ksqd
抗生	kssm
炕上	kssp
抗生素	kssu
康泰	ksth
抗癌	ksvh
抗药	ksyd
抗药	ksyk
康庄	kszc
扛着	ksze
抗灾	kszh
抗战	kszj
卡尔蔡司	kvcs
开胃生津	kwsj
口无遮拦	kwzl
林区	lbqv
两侧	lccs
良辰吉日	lcjr
了却	ldqz
疗养	ldys
联邦	lfbs
零钱	lgqj
灵光一闪	lgys
缆车	ljcs
缆线	ljxj
懒腰	ljyd
拉开序幕	lkxm
拉普拉斯	lpls
刘邦	lqbs
狼狈	lsbw
狼疮	lscc
浪费	lsfw
狼狗	lsgr
狼孩	lshh
狼嚎	lshk
浪花	lshs
浪叫	lsjd
狼藉	lsji
郎君	lsjy
朗朗	lsls
朗然	lsrj
朗声	lssm
朗星	lsxg
历史学家	lsxj
朗讯	lsxy
历史学	lsxz
老鼠药	lsyd
狼烟	lsyj
郎中	lszl
廊柱	lszu
力透纸背	ltzb
累月	lwyz
理想信念	lxxn
滥竽充数	lycs
礼仪小姐	lyxj
礼仪之邦	lyzb
立足于	lzyv
没必要的	mbyd
满打满算	mdms
美国历史	mgls
明月	mgyz
麦浪	mhls
蔓延	mjyf
门轴	mnjr
门廊	mnls
名人轶事	mrys
盲测	mscs
忙道	msdk
忙慌	mshc
茫茫	msms
马赛曲	msqu
马赛曲	msqv
买受人	msrn
忙死	mssi
莽撞	mszc
满头大汗	mtdh
密洞	mtdl
漫天飞舞	mtfw
迷宫	mtgl
满堂喝彩	mthc
蜜饯	mtjf
茅台酒	mtjq
眉头紧锁	mtjs
马蹄莲	mtlf
蒙太奇	mtqi
弥撒	mtsa
慢条斯理	mtsl
密谈	mttj
满头银发	mtyf
漫天要价	mtyj
蜜月	mtyz
酶切	mwqn
每样	mwys
没有意思	myys
南冰洋	nbys
难道能	ndns
你的意思	ndys
内分泌	nfmt
那个样子	ngyz
年轻一代	nqyd
纳税人	nsrn
能有	nsyr
那是一个问题	nsyt
男儿有泪不轻弹	nvyd
难以承受	nycs
难以言说	nyys
拼爹	pbdn
聘用	pbvl
排除法	pcfa
赔偿金额	pcjv
陪吃陪喝	pcph
贫血	pcxz
骗钱	pfqj
匹夫有责	pfyz
凭据	pgjv
乒乓	pgps
判若鸿沟	prhg
判若两人	prlr
迫使	prsi
怦然心动	prxd
排水管	psgt
潘石屹	psvi
潘石屹	psyi
盆骨	ptgu
喷绘	pthv
喷施	ptsi
盆子	ptzi
喷嘴	ptzv
捧红	pvhl
泣不成声	qbcs
齐步走	qbjr
亲笔签名	qbqm
枪决	qcjz
千层浪	qcls
抢钱	qcqj
汽车洋房	qcyf
强于	qcyv
倾囊	qgns
千古一帝	qgyd
岂能	qins
气急败坏	qjbh
牵缠	qjcj
旗舰产品	qjcp
千斤顶	qjdg
牵动	qjdl
遣返	qjfj
前锋	qjfm
潜伏	qjfu
谦恭	qjgl
浅黄	qjhc
前景	qjjg
前几	qjji
前奏	qjjr
千钧	qjjy
前景堪忧	qjky
前浪	qjls
千金难求	qjnq
牵盼	qjpj
千金散尽还复来	qjsl
签署	qjsu
欠条	qjtd
前卫	qjww
千金小姐	qjxj
前些	qjxx
弃甲曳兵	qjyb
千钧一发	qjyf
签约	qjyh
前有	qjyr
齐聚一堂	qjyt
千余	qjyu
千余	qjyv
签约	qjyz
潜在	qjzh
前奏	qjzr
乾坤大挪移	qkdy
瞧见	qkjf
敲击	qkji
桥下	qkxs
青龙偃月刀	qlyd
枪棒	qmbs
奇门遁甲	qmdj
签名档	qmdp
强度	qmdu
强光	qmgc
乞悯告怜	qmgl
强劲	qmjb
抢镜	qmjg
枪决	qmjh
抢救	qmjq
强加	qmjs
启蒙教育	qmjy
锵锵	qmqm
枪栓	qmst
抢滩	qmtj
千门万户	qmwh
强行	qmxg
其鸣也哀	qmyv
墙砖	qmzb
强制	qmzi
墙砖	qmzt
呛住	qmzu
强扭的瓜不甜	qndt
前男友	qnyr
恰恰不是	qqbs
秋菊	qqjv
且听下回分解	qtxj
弃恶从善	qvcs
亲爱哒	qvda
强而有力	qvyl
轻喜剧	qxjv
浅显易懂	qxyd
取信于	qxyv
其言也善	qyys
取之不尽	qzbj
其中包括	qzbk
亲自出马	qzcm
取值范围	qzfw
敲竹杠	qzgp
轻重缓急	qzhj
却将	qzjc
亲子鉴定	qzjd
强制力	qzli
罄竹难书	qzns
全知全能	qzqn
钱钟书	qzsu
求职信	qzxb
骑自行车	qzxc
青藏线	qzxf
前瞻性	qzxg
抢占先机	qzxj
奇珍异宝	qzyb
却要	qzyd
其中一个	qzyg
切中要害	qzyh
求知欲	qzyu
求知欲	qzyv
其中一种	qzyz
如果能	rgns
绕月	rkyz
人类学家	rlxj
人要衣装	ryyz
寿比南山	sbns
市场竞争	scjz
市场运作	scyz
双飞燕	sfyf
试管婴儿	sgyv
上个月	sgyz
腮帮	shbs
赛前	shqj
腮腺	shxj
社会学	shxz
势能	sins
时机成熟	sjcs
三周	sjjr
三聚氰胺	sjqv
膳宿	sjxm
闪耀	sjyd
山羊	sjys
搔痒	skys
少赚	skzb
生老病死	slbs
身临其境	slqj
伸懒腰	slyd
生理盐水	slys
什么程度	smcd
声旁	smps
什么情况	smqk
圣贤	smxj
生肖	smxk
什么样的	smyd
什么样	smys
塞内加尔	snjv
身旁	snps
伸腰	snyd
上扬	spys
手肘	srjr
收钱	srqj
射人先射马	srxm
深入细致	srxz
水蛇腰	ssyd
涉案金额	svjv
十二月份	svyf
生物学家	swxj
所需要	sxyd
十一月份	syyf
嗓子眼	szyf
少之又少	szys
始作俑者	szyz
挑灯夜战	tdyz
天桥	tfqk
铁杆球迷	tgqm
停学	tgxz
天高云淡	tgyd
太郎	thls
抬眼	thyf
探测	tjcs
弹奏	tjjr
条件限制	tjxz
痰盂	tjyv
淘米	tkmt
螳螂捕蝉	tlbc
铜雀	tlqz
铁脚	tnjd
贴切	tnqx
铁头	tntr
田纳西州	tnxz
贴有	tnyr
头衔	trxj
体育运动	tyyd
矮胖	vhps
欧罗巴	vlba
阿拉伯联合酋长国	vlbg
按劳分配	vlfp
阿里妈妈	vlmm
鹅卵石	vlsi
阿拉斯加	vlsj
按理说	vlso
俄罗斯人	vlsr
安眠药	vmyd
恶人先告状	vrxz
外邦	whbs
外扬	whys
万状	wjbc
碗碟	wjdn
顽抗	wjks
玩笑	wjxk
婉转	wjzb
外科医生	wkys
闻名遐迩	wmxv
我们要	wmyd
望女成凤	wncf
未能免俗	wnms
稳赚	wnzb
窝囊	wons
围魏救赵	wwjz
微末	wwme
威武雄壮	wwxz
万无一失	wwys
往往意味着	wwyz
弯下腰	wxyd
下不了手	xbls
虾兵蟹将	xbxj
信不信由你	xbxn
邪不压正	xbyz
小拆机器人	xcjr
想要	xcyd
下车伊始	xcys
相约	xcyz
相当程度	xdcd
下得厨房	xdcf
相当程度上	xdcs
效能	xdns
相当一部分	xdyf
相得益彰	xdyz
县局	xfjv
先决	xfjz
行车	xgcs
行囊	xgns
行窃	xgqn
心高气傲	xgqv
相互残杀	xhcs
心怀叵测	xhpc
显赫一时	xhys
新婚燕尔	xhyv
现状	xjbc
宪兵	xjbg
下酒菜	xjch
现存	xjcy
限电	xjdf
限定	xjdg
仙丹	xjdj
现阶段	xjdt
宪法	xjfa
闲晃	xjhc
显赫	xjhe
现汉	xjhj
鲜红	xjhl
戏剧化	xjhs
贤惠	xjhv
细节决定成败	xjjb
袭击者	xjje
洗洁精	xjjg
县级	xjji
现就	xjjq
戏剧家	xjjs
县局	xjjv
仙界	xjjx
下脚料	xjld
下降了	xjle
现金流	xjlq
显露	xjlu
嫌累	xjlw
喜剧片	xjpf
席卷全国	xjqg
仙人	xjrn
县级市	xjsi
先进事迹	xjsj
先生	xjsm
先进水平	xjsp
娴熟	xjsu
先决条件	xjtj
仙童	xjtl
席卷天下	xjtx
现象	xjxc
戏剧性	xjxg
纤纤	xjxj
闲暇	xjxs
鲜艳	xjyf
鲜艳	xjyj
洗劫一空	xjyk
咸阳	xjys
现状	xjzc
袭击者	xjze
先见之明	xjzm
小菜	xkch
小草	xkck
小楷	xkkh
小康水平	xksp
小孙	xksy
线控耳机	xkvj
鲜克有终	xkyz
小康之家	xkzj
心理学家	xlxj
心理医生	xlys
朽木不可雕	xmbd
小卖部	xmbu
小马过河	xmgh
羡慕嫉妒恨	xmjh
小妹妹	xmmw
宿迁	xmqj
小米手环	xmsh
厦门市	xmsi
新墨西哥	xmxg
小蛮腰	xmyd
小蛮腰	xmyk
心满意足	xmyz
小拇指	xmzi
小米之家	xmzj
新民主主义革命	xmzm
修真	xmzn
项目组	xmzu
喜怒不形于色	xnbs
亵渎	xndu
写好	xnhk
西宁市	xnsi
小鸟依人	xnyr
斜阳	xnys
贤内助	xnzu
小拳拳捶你胸口	xqqk
闲情逸致	xqyz
下车	xscs
夏末	xsme
喜上眉梢	xsms
稀松平常	xspc
下线	xsxj
狭小	xsxk
下药	xsyd
下月	xsyz
稀世珍宝	xszb
小偷小摸	xtxm
悉听尊便	xtzb
笑而不答	xvbd
西安电子科大	xvdd
小额贷款	xvdk
西安交大	xvjd
西安交通大学	xvjx
西安理工大学	xvlx
西安市	xvsi
新奥尔良	xvvl
续完	xvwj
相爱相杀	xvxs
显而易见	xvyj
蓄养	xvys
想象不出	xxbc
小学毕业生	xxbs
嬉笑打闹	xxdn
谐谑	xxxz
喜形于色	xxys
小心眼儿	xxyv
小宇宙	xyjr
信噪比	xzbi
行政部门	xzbm
学点	xzdf
下知地理	xzdl
县政府	xzfu
学费	xzfw
卸妆膏	xzgk
西装革履	xzgl
洗澡间	xzjf
行政机关	xzjg
限制级	xzji
现在进行时	xzjs
限制减刑	xzjx
幸灾乐祸	xzlh
喜之郎	xzlp
喜之郎	xzls
闲着没事	xzms
小资情调	xzqd
薛之谦	xzqf
薛之谦	xzqj
行政区	xzqu
行政区	xzqv
惜字如金	xzrj
现在时	xzsi
心醉神迷	xzsm
咸猪手	xzsr
雪中送炭	xzst
线装书	xzsu
卸妆水	xzsv
显著提高	xztg
许志安	xzvj
项庄舞剑	xzwj
选择性	xzxg
新泽西	xzxi
先知先觉	xzxj
新泽西州	xzxz
先走一步	xzyb
修正液	xzye
雄姿英发	xzyf
心中有鬼	xzyg
现在已经	xzyj
卸妆油	xzyr
心中有数	xzys
行政院	xzyt
血战	xzzj
小祖宗	xzzl
小组长	xzzp
也并不是	ybbs
一百多年	ybdn
也不能说	ybns
一般情况	ybqk
也不用	ybvl
阴穴	ybxz
也不要	ybyd
一饱眼福	ybyf
一般意义上	ybys
言不由衷	ybyz
一次性筷子	ycxz
要把	ydba
摇摆	ydbh
要比	ydbi
腰板	ydbj
腰包	ydbk
一大帮	ydbs
要不	ydbu
药厂	ydcp
摇车	ydcs
咬掉	yddd
要得	ydde
要点	yddf
腰带	yddh
要地	yddi
要道	yddk
咬断	yddt
要对	yddv
羊癫疯	ydfm
药粉	ydfn
药费	ydfw
腰杆	ydgj
邀功	ydgl
吆喝	ydhe
耀华	ydhs
要回	ydhv
要将	ydjc
腰脚	ydjd
药剂	ydji
要价	ydjs
药具	ydju
药具	ydjv
要快	ydkg
要看	ydkj
药量	ydlc
药疗	ydld
要了	ydle
要脸	ydlf
腰里	ydli
摇篮	ydlj
要买	ydmh
耀目	ydmu
妖媚	ydmw
药品	ydpb
药品	ydpc
咬人	ydrn
要塞	ydsh
要是	ydsi
窑烧	ydsk
腰上	ydsp
摇手	ydsr
药水	ydsv
尧舜	ydsy
摇头	ydtr
要以	ydvi
要按	ydvj
要用	ydvl
药饵	ydvu
压倒性	ydxg
药学	ydxh
咬下	ydxs
药学	ydxz
药引	ydyb
遥遥	ydyd
摇曳	ydye
耀眼	ydyf
要以	ydyi
耀眼	ydyj
要用	ydyl
要有	ydyr
印度洋	ydys
遥远	ydyt
药浴	ydyu
药浴	ydyv
要在	ydzh
腰肢	ydzi
腰斩	ydzj
药皂	ydzk
言表	yfbd
眼馋	yfcj
验车	yfcs
言传	yfct
掩盖	yfgh
烟花	yfhs
颜料	yfld
言论	yfly
雁门	yfmn
烟幕	yfmu
眼眉	yfmw
燕雀	yfqh
眼前	yfqj
严守	yfsr
演算	yfst
眼线	yfxf
眼线	yfxj
厌学	yfxz
言曰	yfyh
艳阳	yfys
烟云	yfyy
燕子	yfzi
验证	yfzm
雁阵	yfzn
演奏	yfzr
英镑	ygbs
一个劲儿	ygjv
严格来说	ygls
萤囊	ygns
一概而论	ygvl
眼高于顶	ygyd
严格意义上	ygys
一个愿挨	ygyv
雨后春笋	yhcs
有话要说	yhys
眼瞅	yjcd
掩卷沉思	yjcs
一九九二	yjjv
赝品	yjpc
燕雀	yjqz
眼线	yjxj
研修	yjxm
艳阳	yjys
言语	yjyv
言曰	yjyz
也可能	ykns
遥遥	ykyd
一辆车	ylcs
眼力劲儿	yljv
永诀	yljz
摇了摇	ylyd
一楼一凤	ylyf
友邦	yrbs
毅然决然	yrjr
音容笑貌	yrxm
有血	yrxz
样表	ysbd
养病	ysbg
压缩比	ysbi
样板	ysbj
样报	ysbk
养蚕	yscj
阳春	yscy
杨帆	ysfj
养蜂	ysfm
洋房	ysfp
养父	ysfu
秧歌	ysge
羊倌	ysgt
养活	ysho
氧化	yshs
养护	yshu
羊角	ysjd
阳间	ysjf
养鸡	ysji
洋酒	ysjq
养家	ysjs
阳具	ysju
阳具	ysjv
阳界	ysjx
样刊	yskj
杨坤	ysky
养料	ysld
养了	ysle
仰脸	yslf
仰赖	yslh
阳历	ysli
杨柳	yslq
洋楼	yslr
养马	ysma
秧苗	ysmd
仰面	ysmf
鸭舌帽	ysmk
佯谬	ysmq
杨幂	ysmt
羊奶	ysnh
样品	yspb
样品	yspc
样盘	yspj
扬琴	ysqb
央请	ysqg
扬起	ysqi
洋钱	ysqj
阳泉	ysqt
羊绒	ysrl
洋人	ysrn
样式	yssi
阳伞	yssj
仰韶	yssk
养生	yssm
养神	yssn
扬手	yssr
杨树	yssu
阳台	ysth
样题	ysti
仰头	ystr
羊腿	ystv
仰望	yswp
阳痿	ysww
阳线	ysxf
阳性	ysxg
阳线	ysxj
羊血	ysxz
漾印	ysyb
杨颖	ysyg
扬言	ysyj
仰泳	ysyl
痒痒	ysys
养育	ysyu
养育	ysyv
阳宅	yszh
仰仗	yszp
扬州	yszr
预断	yvdt
因爱生恨	yvsh
一二三四	yvss
有二说二	yvsv
勇而无谋	yvwm
又爱又恨	yvyh
隐恶扬善	yvys
幺蛾子	yvzi
一心一德	yxyd
依依不舍	yybs
英英词典	yycd
夜以继日	yyjr
一元钱	yyqj
颐养天年	yytn
鱼与熊掌	yyxz
摇一摇	yyyd
牙痒痒	yyys
一桩桩	yzbc
英姿勃发	yzbf
有种不祥的预感	yzbg
月白	yzbh
一字摆开	yzbk
永志不忘	yzbw
一指禅	yzcj
一字长蛇	yzcs
眼中钉	yzdg
原子弹	yzdj
亚洲大陆	yzdl
一直到今天	yzdt
有资格	yzge
以资鼓励	yzgl
有则改之无则加勉	yzgm
原子核	yzhe
约翰	yzhj
也只好	yzhk
一战后	yzhr
一枝花	yzhs
演奏家	yzjs
邮政局	yzju
邮政局	yzjv
一针见血	yzjx
远征军	yzjy
一字连城	yzlc
异指连击	yzlj
一走了之	yzlz
一字马	yzma
又怎么	yzme
原子能	yznm
原子能	yzns
与之匹敌	yzpd
一字排开	yzpk
颜真卿	yzqg
一掷千金	yzqj
一柱擎天	yzqt
一直是	yzsi
俞正声	yzsm
一转身	yzsn
原则上	yzsp
宇宙万物	yzww
与之相比	yzxb
语重心长	yzxc
有贼心没贼胆	yzxd
有这样的	yzyd
养殖业	yzye
有这样	yzyp
有朝一日	yzyr
一招一式	yzys
幼稚园	yzyt
以至于	yzyu
以至于	yzyv
一战之后	yzzh
一阵子	yzzi
饮鸩止渴	yzzk
原子钟	yzzl
眼睁睁	yzzm
转变	zbbf
躜步	zbbu
专才	zbch
重磅出击	zbcj
找不出来	zbcl
周笔畅	zbcp
珠宝店	zbdf
转到	zbdk
找不到了	zbdl
主办方	zbfp
转干	zbgj
转告	zbgk
战败国	zbgo
转不过弯	zbgw
专横	zbhm
准备着	zbje
专辑	zbji
治病救人	zbjr
这不就是	zbjs
猪八戒	zbjx
睁不开眼睛	zbkj
正比例	zbli
转轮	zbly
砖砌	zbqi
主办权	zbqt
闸北区	zbqu
闸北区	zbqv
值班室	zbsi
中饱私囊	zbsn
这本书	zbsu
这步田地	zbtd
制表位	zbww
照本宣科	zbxk
这不一样	zbyy
找不着北	zbzb
准备着	zbze
在不在	zbzh
专制	zbzi
站不住脚	zbzj
专政	zbzm
转账	zbzp
转走	zbzr
止不住	zbzu
杂草丛生	zccs
张弛有度	zcyd
展翅欲飞	zcyf
张大千	zdqj
指点一二	zdyv
战国策	zgcs
在于	zhyv
斋月	zhyz
只能	zins
战车	zjcs
展品	zjpc
暂缺	zjqz
展现	zjxj
毡靴	zjxz
斩妖	zjyd
赞曰	zjyz
辗转	zjzb
这可能是	zkns
照样	zkys
战略部署	zlbs
株连九族	zljz
中魔	zlme
中签	zlqj
中央	zlys
这么些年	zmxn
怎么样的	zmyd
这么样	zmys
这么一种	zmyz
真切	znqn
责任有限公司	zrys
在水一方	zsyf
之所以说	zsys
针头线脑	ztxn
抓耳挠腮	zvns
植物学家	zwxj
张小娴	zxxj
最需要	zxyd
在线状态	zxzt
职业经理人	zyjr
准能	zyns
只有一点	zyyd
直痒痒	zyys
占有欲	zyyv
早知今日	zzjr
只知其一不知其二	zzqv
政治学家	zzxj
最重要	zzyd
眨眨眼	zzyf
正中央	zzys
悲从中来	bczli
柏杨	bhyse
百试不爽	bsbse
抽丝	cdsii
惨跌	cjdno
侧键	csjfi
侧击	csjii
车展	cszje
单反相机	dfxjo
骄阳	jdysa
几个意思啊	jgyvu
九浅一深	jqysu
建筑师	jzsia
急诊室	jzsiu
狼籍	lsjiu
密探	mttjo
眉头一皱	mtyza
那麽	namea
那倒也是	ndysa
泼妇	prfua
破解	prjxe
千载一时	qzysu
生药	smydu
神马样	smyso
爱丽丝	vlsiu
行成于思毁于随	xcysu
校阅	xdyze
先奸后杀	xjhsu
贤慧	xjhvi
喜剧性	xjxge
显眼	xjyfo
显眼	xjyjo
席卷一空	xjyko
小米手机	xmsji
胸中有数	xzysu
新自由主义	xzyyo
也不由得	ybyda
有必要	ybyde
远程协助	ycxze
遥拜	ydbhu
腰袋	yddhu
邀人	ydrnu
要死	ydsie
要义	ydvie
要案	ydvje
要义	ydyie
沿线	yfxfa
艳羡	yfxfe
沿线	yfxja
艳羡	yfxje
研制	yfzie
一个样	ygyse
荥阳	ygysi
一个愿打一个愿挨	ygyve
约么	yhmea
一荤一素	yhyse
要能	yknse
杨坚	ysjfe
压缩机	ysjie
样例	yslie
杨澜	yslje
杨氏	yssie
央视	yssii
洋洋	ysysa
样样	ysyse
怏怏	ysyso
扬长	yszpi
应用价值	yyjzo
一一映射	yyyse
用之不竭	yzbju
一直到	yzdke
有中国特色的社会主义道路	yzgle
验证码	yzmaa
一直有	yzyre
有助于	yzyue
有助于	yzyve
转笔刀	zbdke
增白剂	zbjie
传记	zbjii
转变经济发展方式	zbjse
昭阳	zkyso
怎么一回事	zmysu
最主要	zzydo
在这一点上	zzyse
照这样	zzyso